1111111111111111111111111111
1P00000000000C000C0C0C0C0C01
1000000C0CCCC00000C000C0C0C1
11111CCC001CCCC000CCCC111111
1111111111111111C11111111111
111111111111111CCC1111111111
1111111CCC000000CCCC000CCCC1
1000000000000000000000C00001
1E11000CCCC00000000C11111111
1111111111111111111111111111