1111111111
1PCCCCCCC1
1CCCCCCCC1
1ECCCCCCC1
1111111111