11111111111111111111
1P000000000000000C01
1E000000000000000001
11111111111111111111