111111111111111111
10000E0000P0C00001
10000000C000000001
1110CC000CC0000011
1C0111100000000001
110111101010010101
100011101011001011
1C00000000C1111111
111111111111111111