111111111111111111
10000E0000P0C00001
10000000C0000000001
1110CC000CC0000011
1C01111000000000001
110111101010010101
1000111010110010101
1C00000000C1111111
111111111111111111