1111111111111
10111110101011
100000P1111011
1CCE1000000011
1000000000001
1000CCC001001
1111111111111
