NO ./textures/bluestone.xpm
SO ./textures/wood.xpm
EA ./textures/redbrick.xpm
WE ./textures/greystone.xpm

C 135,200,235
F 127,127,127

        11111111111    11111111111111
        10000000001    10000000000001
        10110000011111110001000011111
        1001000000000000000000001
111111111011000001110000000000001
100000000011000001110111101111111
11110111111111011100000010001
11110111111111011010100100001
11000000110101011100000010001
10001000001110001100000010001
10000000001 10001101010010001
11000001111111011111011110W0111
10110101 1010101 101111010001
11111111 1111111 1111111111111