NO ./textures/bluestone.xpm
SO ./textures/wood.xpm
EA ./textures/redbrick.xpm
WE ./textures/greystone.xpm

C 135,206,235
F 127,127,127

 1111111111111        11111111111111111111
11000000000001       110000000000000000001
10000000000001       100000000000000000001
10000000000001       100000000010000000001
10000000000001       100000000001110000001
100000000000011111111100000000001 10000001
100000000000000000000000000000001110000001
100000000001011111111100000000000000000001
10000000000001       100000000000001000001
10000000000001       100000000000000100001
10000000001001       100000000000000000001
10000000000001       1000000000000000W0001
11111111111111       111111111111111111111