NO ./textures/bluestone.xpm
SO ./textures/wood.xpm
EA ./textures/redbrick.xpm
WE ./textures/greystone.xpm

C 135, 206, 235
F 127, 127, 127

11111111111111111111111111111111111
10000000000000000000000000000000001
10000000000000000000000000000000001
10000000000000000000000010000000001
10000000000000000000000000000000001
10000000000000000000000000000000001
10000000000000000000000000000000001
10000000000100000000000010000000001
10000000000000000000000000000000001
10000000000000000000000000000000001
10000000001000000000000000000000001
1000000000000000W000000000000000001
11111111111111111111111111111111111